####000#########
#a00000#a000t00#
e000000e0000t00#
e000000eee###00#
e00000000000000#
e00000000000000#
#00000000000000e
#ccccc#tt#00000e
#0ccc0#00#00000e
#00000e00#00000e
#00000e00#00000#
e00000#rr#00000#
#0000a#00e00000#
#dd000#00#00000#
#dd000#bb#0000a#
##eee##e####e###
