######00000#####
#00000000000000#
#00000000000000#
#00000000000000#
#00000000000000#
#00000000000000#
#00000000000000#
#00000000000000#
#00000000000000#
#00000000000000#
#00000000000000#
#00000000000000#
#00000000000000#
#00000000000000#
#00000000000000#
######00########
