##eee#00z###e###
#0000@00zg0zzz=#
#g000|00zz0z00g#
#0000@0000z0000#
e0000@000000d00#
e000d@000000000#
e0000@000d00000e
e0000@000000000#
ea000@000000000#
#*v**@*********e
#0000@000000000e
ec000@000000000e
#j000zzzz000000#
#jj00zzzzzzz0aj#
ea0000zz00000jje
eee###zz##e##eee
