######0000######
#00000000000000#
#00000000000000#
#00000000000r00#
#00000000000000#
#00000000000000#
#00000000000000#
#00000000000000#
#00000000000000#
#00000000000000#
#00000000000000#
#00000000000000#
#00000000000000#
#00000000000000#
#00000000000000#
################
