######000#######
#00000000000000#
#00000000000000#
#0000g000000000#
#000000000g0000#
#000000g0000000#
#00000000000000#
#00000000000000#
#00000000000000#
#00000000000000#
#00000000000000#
#00000000000000#
#000000000ddd00#
#00000000000000#
#00000000000000#
######00########
