##eee#00##e#####
#g#fzz000ee#c0d#
#0#0zf0d0e##000#
e0000f000#00000#
e0r#00e00#000#0#
e00#00j00#j00#0#
#00e00ee0#j0##b#
#aee000zz000#eee
####00ff0000##ee
#j00000ee##00#ee
#000000ez00000##
#tt#b00#fr0000##
#dz#000#####000#
ez0#00000f00000#
efk#000fff00e###
e###000ee####e##
