######0000######
#00000000000000#
#00000000000000#
#00000000000r00#
#0kkkk000000000#
#00000000000000#
#00000000000000#
#0llll000000000#
#00000000000000#
#00000000000000#
#00000000000000#
#00000000000000#
#00000000000000#
#00000000000000#
#00000000000000#
################
