##eee#00z###e###
#0000c00zg0zzza#
#g000000zz0z00g#
#000000000z0000#
e00000000000d00#
e000d0000000000#
e00000000d00000e
e000000000000n0#
ea0000000000000#
#00000000000000e
#0000000000o000e
ec0000000000000e
#j000zzzz000000#
#jj00zzzzzzz0aj#
ea0000zz00000jje
eee###zz##e##eee
