####000#########
#a00000#a000t0j#
e000z00ed000t00#
e000zf0eee###00#
e000zf000000000#
e0000fzz0000000#
#00000zfz000000e
#ccccc#tte000zze
#0ccc0#00e00zzze
#0000fe00ezzzz0e
#zf00fe00#z0z00#
ezff0f#rr#00000#
#fff00#00e00000#
#jzff0#00#j0000#
#jjzff#bbejj00a#
##eee##e####e###
