######00000#####
#00000000000000#
#00000000000000#
#00000000000000#
#00000000000000#
#00000000000000#
#00000000000000#
#00000000000000#
#00000000000000#
#00000000000000#
#00000000000000#
#00000000000000#
#00000000000000#
#00000000000000#
#00000000000000#
######00########
#0#000000###000#
#0#000000###000#
#00000000#00000#
#0r#00#00#000#0#
#00#00#00#000#0#
#00#00##0#00##}#
#0##00000000####
####k00l0000####
#000000####00###
#000000#000000##
#{}#}00#0r0000##
#00#000#####000#
#00#00000000000#
#00#00000000####
