###e000##ee#####
#a00000#=000p0j#
e000z00ed000p00j
e000zf0eee###00#
e00000000000000#
e0000fzz0000000#
#00000zf0000000e
#ccccc#ete000z0e
#0ccc0#e0e00000e
#0000fe#0ezz0z0e
#zf00fe#0#z0z00#
ezff0f##r#00000#
#fff00e#0e00000#
#jzff0#e0#j0000#
#jjzff#ebejj00aj
##eeej#e####e###
