##eeee###eee##ee
#e###beb#beb##ee
e$$e#0e0#0#0#lfe
e$$#e0#0e0#0e0f#
e#e##0#0e0#0#0f#
#f0a#r#r#r#r#tt#
#ff00000c000fff#
]ff0000000fff0a#
[fff00f00000000e
#0ff0ff00000000e
#00000000000000e
ett#ee000#tt#tte
#00#fe00f#0d#00e
#d0#ff0ff#d0#0d#
#0d#ffff0#00#d0#
##ee##000#ee####
