##eeee####e###ee
#e###bbb#bbb##ee
e$$e#000#000#l0e
e$$de000e000#00#
e#e##000e000#00#
#000#rrr#rrr#tt#
0000d000c000000#
00000000000000a#
000000000000000e
000000000000000e
#00000000000000e
ett#ee000#tt#tte
#00#de000#00#00e
#00#00000#00#00#
#00#0d000#00#00#
##ee##000#ee####
