0000000000000000
000000####000000
000000#$$#000000
000000#{}#000000
000000#00#000000
000000#00#000000
000000#00#000000
000000#00#000000
000000#00#000000
000000#00#000000
000000#00#000000
000000#00#000000
000000#00#000000
000000#00#000000
000000#00#000000
000000#00#000000
