mmmmmm0000mmmmmm
m0000m0000m0000m
m0000mmttmm0000m
m0000mm00mm0000m
m00000000000000m
m00000000000000m
mmttmm0000mmttmm
m0000p0000p0000m
m00o0p0000p0n00m
mmttmm0000mmttmm
m00000000000000m
m00000000000000m
mb0000r00r0000bm
m00000000000000m
m00000000000000m
mmmmmmmmmmmmmmmm
