######0000######
#$$$$#0000#$$$$#
#$000000000000$#
#$000000000000$#
#$000000000000$#
#$000000000000$#
#$000000000000$#
#$000000000000$#
#$000000000000$#
#$000000000000$#
#$000000000000$#
#$000000000000$#
#$000000000000$#
#$000000000000$#
#$$$$$$$$$$$$$$#
################
