m00000000000000m
m00000000000000m
mmmmmmmmtmmmmmmm
m00m000m0m00m00m
m00m0o0mnm0om00m
m00m000m0m00m00m
mb0r00000000r0bm
m00m00n00000m00m
m00m00000000m00m
mmmm00000000mmmm
m00000000000000m
m**v***********m
m*******v******m
m***********v**m
m00000000000000m
mmmmmm0000mmmmmm
