m00000000000000m
m00000000000000m
mmmmmmmm0mmmmmmm
m00m000m0m00m00m
m00m000m0m00m00m
m00m000m0m00m00m
m00000000000000m
m00m00000000m00m
m00m00000000m00m
mmmm00000000mmmm
m00000000000000m
m00000000000000m
m00000000000000m
m00000000000000m
m00000000000000m
mmmmmmmmmmmmmmmm
