mmmmmm0000mmmmmm
m0000m0000m0000m
m0000mmttmm0000m
m0000mm00mm0000m
m00000@00@00000m
m00000|00@00000m
mmttmm@00@mmttmm
m0000p@00@p0000m
m00o0p@00@p0n00m
mmttmm@00@mmttmm
m00000@00@00000m
m00000@00@00000m
mb00r0@00|0r00bm
m00000@00@00000m
m00000@00@00000m
mmmmmmmmmmmmmmmm
