mmmmmmmmmmmmmmmm
mmmmmmmmmmmmmmmm
mm000000000000mm
qq000000000000mm
qq000000000000mm
mm000000000000mm
mm000000000000mm
mm0000000;:000mm
mm0000000.>000mm
mm0000000,<000mm
mm000000000000mm
mm000000000000mm
mmqqqqqqqqqqqqmm
mmqqqqqqqqqqqqmm
mmmmmmmmmmmmmmmm
mmmmmmmmmmmmmmmm
