################
#00000000000000#
#00000000000000#
#00000000000000#
#00000000000000#
#0$$00000000000#
#0$$000000000000
#0$$000000000000
#0$$000000000000
#0$$000000000000
#0$$00000000000#
#0$$00000000000#
#00000000000000#
#00000000000000#
#00000000000000#
################
