mmmmmmmmmmmmmmmm
m00000000000000m
m0000o000000000m
m00000000000000m
mmmm00000000000m
m00m00000000000m
m00m000000000000
m=0o000000000000
m00m000000000000
m00m000000000000
mmmm00000n00000m
m00000000000000m
m0000n000000000m
m00000000000000m
m00000000000000m
mmmmmmmmmmmmmmmm
